40
26
0000000000000000000000000000000000000000
0333333333333333333333333335333333333330
0411611122222111111111111111111111111140
0411111122222111111111111111111111111140
0411111122222111111111111111111111111140
0411111112222111111111111111111111111140
0411222222111111111111111111111111111140
0411222222111111111111111111111111111140
0411222222111111111111111111111111111140
0411222222111111111111111112222111111140
0411222222111111111111111112222111111140
0411222222111111111111111112222111111140
0411111111111111111111111112222111111140
0411111111111111211111111111111111111140
0411111111111111211111111111111111111140
0411111111111111111111111111111111111140
0411111111111111111111111111111111111140
0411111111222211111111111111111111111140
0411111111111111111111111111111111111140
0411111111111111111111111111111111111140
0411111111111111111111111111111111111140
0411111111111111111111111111111111111140
0411111111111111111111111111111111111140
0411111111111111111111111111111111111140
0333333333333333333333333333333333333330
0000000000000000000000000000000000000000
