40
25
0000000000000000000000000000000000000000
0333333333533333333333333333333333333330
0411111111111111111111111111111111111140
0461111111111111111111111111111111111140
0411111111111111111111111111111111111140
0411111111111111111111111111111111111140
0411111111111111112222111111111111111140
0411111111111111112222111111111111111140
0411111111111111112222111112211111111140
0411111111111111111112211112211111111140
0411111111111111111112211112211122211140
0411111111111111111112211112211122211140
0411111111111111111111111111111122211140
0411111111111111111111111111111122211140
0411111111111111111111111111111111111140
0411111112221111111111111111111111111140
0411111112221111111111111111111111111140
0411111112221112222222222111111111111140
0411111112221112222222222111111111111140
0411111111111112222222222111111111111140
0411111111111111111111111111111111111140
0411111111111111111111111111111111111140
0411111111111111111111111111111111111140
0333333333333333333333333333333333333330
0000000000000000000000000000000000000000
