40
26
0000000000000000000000000000000000000000
0333333333333353333333333333333333333330
0411111111111111111111111111111111111140
0411111111111111122211111111111111111140
0411111111111111122211111111111111111140
0411111111111111161111111111111111111140
0411111111111111111111111111111111111140
0411111111112222222222111111111111111140
0411111111112222222222111111111111111140
0411111111112222222222111111111111111140
0411111111112222222222111111111111111140
0411111111112222222222111111111111111140
0411111111112222222222111111111111111140
0411111111111111111111111111111111111140
0411111111111111111111111111111111111140
0411111111111111111111111111111111111140
0411111111111111111111111111111111111140
0411111111111112221111111111111111111140
0411111111111112221111111111111111111140
0411111111111112221111111111111111111140
0411111111111112221111112221111111111140
0411111111111111111111211111111111111140
0411111111111111111111111111111111111140
0411111111111111111111111111111111111140
0333333333333333333333333333333333333330
0000000000000000000000000000000000000000
