39
25
000000000000000000000000000000000000000
035333333333333333333333333333322233330
041222222222211111111111111111111111140
041222222222211111111111111111111111140
041222222222211111111111111111111111140
041111111111111111111111111111111111140
041111111111111111111111111111111111140
041111111111111111111111111111111111140
041111111111111111111111111111111111140
041111111111111111111111111111111111140
041111111111111111111111111111111111140
041111111111111111111111111111122221140
041111111111111111111111111111111111140
041111111111111111111111111111111111140
041111111111111111111111111111111111140
041111122221111611111111111111111111140
041111122221111111111111111111111111140
041111122221111111111111111111111111140
041111111122221111111111111111111111140
041111111122221111111111111111111111140
041111122222221111111111111111111111140
041111122221111111111111111111111111140
041111122221111111111111111111111111140
033333333333333333333333333333333333330
000000000000000000000000000000000000000
